NO ./textures/W3d_bluecell.xpm
SO ./textures/W3d_bluecell.xpm
WE ./textures/W3d_bluecell.xpm
EA ./textures/W3d_bluecell.xpm

F 220,100,0
C 225,30,0

        1111111111111111111      1111111111111111
        1000000000110000001      1000000000000001
        1011000001110000001      1000000000000001
        1001000000000000001      1000000000000001
111111111011000001110000001      1000000000000001
1000000000110000011111111111111111000000010000001
1111011111111100001    10000000000000000000000011111111
1111011111111100001    10101000000111111111111111
1100000011010100001    10000000000000000000001
1000000000000000001    100000000001000000000011111
1000000000000000001    100010000001000000000000111
1100000111010100001    100011110001111111111111111
111101000000000000111111100000111111111111111111111
10000000000000000000E00000000000000000000000000001
10000000000000000000000000000000000000000001111111
11111111100000000000000000000000000000000001111
        111111111111111111111111111111111111