
NO ./textures/Kyubie42.xpm
SO ./textures/Sakura42.xpm
WE ./textures/Tori42.xpm
EA ./textures/Tree42.xpm

F 220  ,100  , 0
C 225 ,  30  , 0

1111111111111111
1010000000000001
1010000100000111
1010000N000100000001
1000000000010001
1111111111111111